
 SO     assets/bluestone.xpm
    NO	    assets/colorstone.xpm
 EA	assets/eagle.xpm
WE	    assets/wood.xpm

	F	100,100,         100 
			C 200,200,200



 1111111
1222100111111111111111111
122210000000000000020001
1222D00111111111111110101
12E20001             111
11210001   11
1111D11   1221
1010221   111
1111111
