 SO     assets/bluestone.xpm
    NO	    assets/colorstone.xpm

	F 	0 ,0	,          0
			C 255,255,255
 EA	assets/eagle.xpm
WE	    assets/wood.xpm










1111111111111111111111111111111111111111             1
1000000000000000000000000000000000000001            101
1000000000000000000000000000000000000001             1
100000000000000000000000000010000000001
100000001000000000000000000110000000001
100000001000000000000000000111000000001
1111111110000000000000000000110000000001
100000000000N000000000000000000000000001
1000000000000000000000000000000000000001
1111111111111111111111111111111111111111
1000000000000000000000000000000000000001
1111111111111111111111111111111111111111     1
                                            101
                                             1
						
111111111111111
